F 12, 200,2
C 15,255,255

NO textures/texture1.xpm
SO textures/texture2.xpm
WE textures/texture3.xpm
EA textures/texture4.xpm
S  textures/textures.xpm

R 1080 720

1111111111111111111111111111111111111111111111111111
1000000000000000000000000S00000000000000000000000001
1000000000000000000000000000000000000000000000000001
1111111111111111111111000000011111111111111111100011                                                      11111111111111
                     100000001                10001                                                       10000000000001
                     100002001                10001                                              11111111 10001110000001
                     100000001                1000111111111111                                   10000001110001 10000001
                     100000001                1000000000000001                                   10000000000001 10000001
        111111111111110000000111111111111111111111111111111001111111111111111                    11111111111111 10000001
        100000000000000000000000000000000000000000000000000000000000000000001                    11111111111111110000001
        100001111111110000000111111111111111111111111111111111111111111100001                    10000000000000000000001
        100001       100000001                                         100001                    10000001111111111111111
        100001       100000001                                         100001                    10000001
        100001       100000001                                         100001                    10000001
        100001       100000001                                         100001                    10000001
        100001       100000001                                         100001                    10000001
        111111       100020001                                         100001                    10000001
                     100010001                                         100001                    10000001
                     100000001111111111111111111111111111111111111111111000011111111111111111111110000001
                     100000000000000000000000000000000000000000000000000000000000000000000000000000000001
                     100000000000000000000000000000000000000000000000000000000000000000000000000000000001
                     111111111111111111111111111111111111111111111111111111111111111111111111111111111111
