R 1080 720

F 255,255,20
C 0,0,0

SO textures/texture2.xpm
WE textures/texture3.xpm
NO textures/texture1.xpm
EA textures/texture4.xpm
S  textures/textures.xpm

1111111111111111111111  11111111111111111111111111
1000000000000000000001  10000000000000000000000001
1000000000000000000001  10000000000000000000000001
1000000000000000000001  10000000000000000000000001
1000000000000001111111  11111100000000000000000001
1111100000111111             111111111100001111111
    1000001                           100001
    1000001                           100001
    1000001                           100001
    1000001                           100001
    1000001                           100001
1111100000111111             111111111100001111111     
1000000000000001             100000000000000000001
1000000000000001111111  11111100000000000000000001
1000200000000000000001  10000000000000020000000001             
1000000000000000000001  100000000000000N0000000001           
1000000000000000000001  10000000000000000000000001             
1111111110011111111111  11111111110011111111111111             
        1001                     1001         
        10011111111111111111111111001           
        10000000000000000000000000001         
        11111111111111111111111111111                   
